   R 800 600
F 133, 0160, 000000000000000000000000000000000000000000000000000000000000254
C 20 ,70,160

NO /home/alexander/CLionProjects/cub/textures/no.xpm
SO /home/alexander/CLionProjects/cub/textures/so.xpm
EA /home/alexander/CLionProjects/cub/textures/ea.xpm
WE /home/alexander/CLionProjects/cub/textures/we.xpm
S /home/alexander/CLionProjects/cub/textures/obj.xpm

11111111111111111111111111111111111111111111111
10000000000001000000000000000000000000000000001
10000000000000000000000000000000000000000000001
10000000100000000000011111111111111100000000001
10000000000000000000000000000000000000000000001
10000000000100000200011111111111111111110001111
10000000000000000200000000000000000000000000001
10000000000000000200000010000000000000000000001
100000E0100010000200000000000000000000000000001
11110000000000000200011111111111111111111100001
11111111111111111111111111111111111111111111111

11111111111111111111111111111111111111111111111
100000000000000000000000000000000011     100001
10000000000000000000000000110000000111111100001
10000000000000000000000000000001000000000000001
10000000000000000000110000000000000000001111111
10000000000000000001100000110000000000010000001
10000000000000000011000000000100000000000010001
10000000000000000110000010000000000001001100001
10000000000000001100000000000010000000110000001
10000000000000011000000000001000000001100000001
10000000000000000000000000000000000000000000001
11111111111111111111111111111111111111111111111