R                 1280                     1024
   F 133,    0160,      000000000000000000000000000000000000000000000000000000000000254
C 20 ,70 , 160

NO /Users/bseven/cub3d/textures/no.xpm
SO /Users/bseven/cub3d/textures/os.xpm
EA /Users/bseven/cub3d/textures/ea.xpm
WE /Users/bseven/cub3d/textures/we.xpm
S /Users/bseven/cub3d/textures/obj_pillar.xpm
 
11111111111111111111111111111111111111111111111
10000000000001000000000000000000000000000000001
10000000000000000000000000000000000000000000001
10000000100000000200011111111111111100000000001
10000000000000000000000000000000000000000000001
10000000000100000200011111111111111111110001111
10000000000000000000000000000000000000000000001
10000000000000000200000010000000000000000000001
10000000100010000000000000000000000000000000001
1111E000000000000200011111111111111111111100001
100000000000000000000000000000000011     100001
10000000000000000000000000110000000111111100001
10000200000000200000000000000001000000000000001
10000000000000000000110000000000000000001111111
10000000000000000001100000110000000000010000001
10000000000200000011000000000100000000000010001
10000000000000000110000010000000000001001100001
10020000000000001100000000000010000000110000001
10000000000000011000000000001000000001100000001
10000000000000000000000000000000000000000000001
11111111111111111111111111111111111111111111111
